111111111
100000001
100000001
1P0000001
110000001
1EC000001
111111111