111111111111
1C0000000001
100000000001
1P000000C001
110000000001
1E0000000001
111111111111