111111111
1000000C1
100000001
1P0000001
110000001
1E0000001
111111111